111111111111111111111111111111111
100000000000002211000000000000001
100001000110000011101000110000011
101011000010000000001000010000001
101001000110000011101000110000011
101111000000000001001000000000001
100001001110101111111001110101111
101001001110101111111001110101111
100000001005000110100001000000111
100001000000000010001000002000001
101001000000000000001000000000001
101111401000400110101001000000111
101111401000300110101001030225111
100000430000000001100000000000001
100221000110000011101000114444411
100001000010000000001000010000001
100051000110000011101000110000011
101111000000500001001000040000001
100001001110101111111001110101111
101000001110101111110001114101111
100000001000000110100001000000111
100001000000000000021000000000001
141001000000000000201000000000001
131111001420000112131001000000111
151111221521222110101021000000111
111111111111111111111111111111111
