111111111111111111111111111111111
100000000000000001100000000000001
100001000110000011101000110000011
100001000010000000001000010000001
100001000110000011101000110000011
101111000000000001001000000000001
100001001110101111111001110101111
101001001110101111111001110101111
100000001005000110100001000000111
100001000000000010001000002000001
101001000000000000001000000000001
101111401000400110101001005000111
101111401000300110101001000000111
100000034000000001100000000000001
100221000110033311101000110000011
100001000010035300001000010000001
100051000110033311101000110000011
101111000000500001001000000000001
100001001110101111111001110101111
101000001110101111110001110101111
100000001000000110100001000000111
100001000000000000001000000000001
101001000000000000001000000000001
101111001000000110101001000000111
101111001000000110101001000000111
111111111111111111111111111111111
