R 1280 720

NO ./textures/wood.xpm
SO ./textures/greystone.xpm
WE ./textures/redbrick.xpm
EA ./textures/eagle.xpm
S ./textures/duck.xpm

F 38, 80, 25
C 0, 100, 255

1 1 1 1 1 1 1 1 1 1 1 1 
1 0 1 1 1 1 5 0 4 1 1 1
1 3 0 0 1 1 1 0 1 1 1 1
1 0 0 0 0 0 0 0 0 0 0 1
1 0 1 1 1 1 3 1 1 1 0 1
1 0 1 0 0 5 5 1 0 0 0 1
1 0 4 0 1 N 1 5 0 1 0 1
1 0 0 0 1 1 1 1 1 1 0 1
1 4 1 1 1 1 5 1 1 1 0 1
1 0 0 0 0 0 0 1 1 3 0 1
1 0 0 0 0 0 0 0 0 0 0 1
1 1 1 1 1 1 1 1 1 1 1 1